11 9
S.........5
.##########
..........4
.##########
..........3
.##########
..........2
.##########
..........1
