11 9
S..........
..1........
.....#.....
...########
...2.......
...#.......
#...3......
.....4###..
...##..5...
